111111111111111
1PCCCCC0E111111
111111111111111
100000000000001
111111111111111